1 1 1 1 1 1 1 1 1 1
1 s 1 0 1 a 1 0 0 1
1 0 1 0 0 0 1 0 1 1
1 0 1 0 1 1 1 0 1 1
1 0 0 0 1 0 0 0 0 1
1 0 1 0 1 0 1 1 1 1
1 0 1 1 1 0 1 e 0 1
1 0 1 0 b 0 1 1 0 1
1 0 0 0 1 0 0 0 0 1
1 1 1 1 1 1 1 1 1 1